0,1,2,3,4,5,6,7,8,9,10,11,12,13,14,15,16,17,18,19,20,21,22,23,24,25,26,27,28,29,30,31,32,33,34,35,36,37,38,39,40,41,42,43,44,45,46,47,48,49
1449,1374,1325,1252,1380,1304,1215,1473,1259,1232,1262,1455,1430,1125,1301,1387,1170,1240,1294,1389,1331,1337,1333,1139,1410,1379,1355,1391,1353,1353,1523,1170,1285,1344,1243,1290,1380,1157,1369,1683,1271,1145,1202,1324,1276,1540,1304,1402,1357,1204
1443,1535,1486,1413,1373,1464,1375,1466,1419,1392,1422,1448,1423,1285,1461,1547,1331,1400,1454,1382,1491,1497,1494,1299,1570,1373,1317,1390,1347,1347,1517,1331,1409,1714,1404,1450,1374,1318,1529,1620,1431,1306,1362,1694,1436,1533,1464,1562,1517,1364
1484,1409,1360,1287,1414,1339,1250,1508,1293,1267,1296,1489,1464,1159,1335,1422,1205,1274,1328,1423,1366,1372,1368,1174,1444,1414,1390,1425,1388,1388,1558,1205,1320,1378,1278,1325,1415,1192,1403,1717,1305,1180,1236,1359,1311,1574,1338,1436,1392,1239
1318,1410,1361,1288,1248,1339,1250,1341,1294,1267,1297,1323,1298,1160,1336,1422,1206,1275,1329,1257,1366,1372,1368,1174,1445,1248,1192,1265,1222,1221,1392,1205,1320,1589,1279,1325,1249,1193,1404,1495,1306,1181,1237,1569,1311,1408,1339,1437,1392,1239
1408,1500,1451,1378,1339,1430,1341,1432,1384,1358,1387,1414,1389,1251,1426,1513,1296,1365,1419,1348,1457,1463,1459,1265,1536,1338,1283,1356,1312,1312,1482,1296,1411,1679,1369,1416,1339,1283,1494,1586,1396,1271,1327,1660,1402,1499,1430,1527,1483,1330
1472,1397,1348,1275,1402,1326,1238,1495,1281,1255,1284,1477,1452,1147,1323,1409,1193,1262,1316,1411,1354,1359,1356,1161,1432,1402,1377,1413,1376,1375,1546,1193,1308,1366,1266,1312,1403,1180,1391,1705,1293,1168,1224,1347,1299,1562,1326,1424,1379,1226
1481,1406,1357,1284,1412,1336,1247,1505,1291,1264,1294,1486,1462,1157,1332,1419,1202,1272,1326,1421,1363,1369,1365,1171,1442,1411,1387,1423,1385,1385,1555,1202,1317,1376,1275,1322,1412,1189,1401,1715,1303,1177,1234,1356,1308,1572,1336,1434,1389,1236
1230,1322,1273,1200,1160,1252,1163,1254,1206,1180,1209,1235,1210,1072,1248,1334,1118,1187,1241,1170,1279,1284,1281,1086,1357,1160,1104,1177,1134,1134,1304,1118,1196,1263,1352,1237,1161,1105,1316,1407,1218,1093,1149,1272,1224,1320,1251,1349,1305,1151
1408,1500,1451,1378,1338,1429,1340,1431,1384,1357,1387,1413,1388,1250,1426,1512,1296,1365,1419,1347,1456,1462,1459,1264,1535,1338,1282,1355,1312,1312,1482,1296,1410,1679,1369,1415,1339,1283,1494,1585,1396,1271,1327,1659,1401,1498,1429,1527,1482,1329
1219,1311,1262,1189,1150,1241,1152,1243,1195,1169,1198,1225,1200,1062,1237,1324,1107,1176,1230,1159,1268,1274,1270,1076,1347,1149,1094,1167,1123,1123,1293,1107,1222,1490,1180,1227,1150,1094,1305,1397,1207,1082,1138,1471,1213,1310,1241,1338,1294,1141
1290,1382,1333,1260,1220,1312,1223,1314,1266,1240,1269,1295,1270,1132,1308,1395,1178,1247,1301,1230,1339,1345,1341,1146,1417,1220,1164,1238,1194,1194,1364,1178,1256,1561,1251,1297,1221,1165,1376,1467,1278,1153,1209,1541,1284,1381,1311,1409,1365,1211
1477,1402,1353,1280,1408,1332,1243,1501,1287,1260,1290,1482,1458,1153,1328,1415,1198,1268,1321,1417,1359,1365,1361,1167,1438,1407,1383,1419,1381,1381,1551,1198,1313,1372,1271,1318,1408,1185,1397,1711,1299,1173,1230,1352,1304,1568,1332,1430,1385,1232
1618,1710,1661,1588,1548,1639,1550,1641,1594,1567,1597,1623,1598,1460,1636,1722,1506,1575,1629,1557,1666,1672,1668,1474,1745,1548,1492,1565,1522,1521,1692,1505,1584,1651,1578,1625,1549,1493,1704,1795,1606,1481,1537,1659,1611,1708,1639,1737,1692,1539
1455,1380,1331,1258,1385,1310,1221,1478,1264,1238,1267,1460,1435,1130,1306,1393,1176,1245,1299,1394,1337,1343,1339,1144,1415,1385,1361,1396,1359,1358,1529,1176,1254,1321,1249,1295,1386,1163,1374,1688,1276,1151,1207,1330,1282,1545,1309,1407,1363,1209
1250,1342,1293,1220,1181,1272,1183,1274,1226,1200,1229,1255,1231,1092,1268,1355,1138,1207,1261,1190,1299,1305,1301,1107,1377,1180,1124,1198,1154,1154,1324,1138,1253,1521,1211,1258,1181,1125,1336,1428,1238,1113,1169,1501,1244,1341,1271,1369,1325,1172
1482,1408,1359,1286,1413,1337,1248,1506,1292,1265,1295,1488,1463,1158,1334,1420,1204,1273,1327,1422,1364,1370,1366,1172,1443,1413,1388,1424,1386,1386,1556,1203,1318,1377,1277,1323,1413,1191,1402,1493,1304,1179,1235,1358,1309,1573,1337,1435,1390,1237
1382,1474,1425,1352,1313,1404,1315,1406,1358,1332,1361,1388,1363,1225,1400,1487,1270,1339,1393,1322,1431,1437,1433,1239,1510,1312,1257,1330,1286,1286,1456,1270,1385,1653,1343,1390,1313,1257,1468,1560,1370,1245,1301,1634,1376,1473,1404,1502,1457,1304
1253,1345,1296,1223,1183,1274,1185,1276,1229,1202,1232,1258,1233,1095,1271,1357,1141,1210,1264,1192,1301,1307,1303,1109,1380,1183,1127,1200,1157,1156,1327,1140,1255,1523,1213,1260,1184,1127,1339,1430,1241,1115,1172,1504,1246,1343,1274,1372,1327,1174
1269,1361,1312,1239,1199,1290,1202,1293,1245,1219,1248,1274,1249,1111,1287,1373,1157,1226,1280,1208,1318,1323,1320,1125,1396,1199,1143,1216,1173,1173,1343,1157,1272,1540,1230,1276,1200,1144,1355,1446,1257,1132,1188,1520,1263,1359,1290,1388,1343,1190
1439,1364,1315,1242,1370,1294,1205,1463,1249,1222,1252,1444,1420,1115,1290,1377,1160,1230,1284,1379,1321,1327,1323,1129,1400,1369,1345,1381,1343,1343,1513,1160,1275,1306,1233,1280,1370,1147,1359,1673,1261,1135,1192,1314,1266,1530,1294,1392,1347,1194
1441,1533,1484,1411,1372,1463,1374,1465,1417,1391,1420,1446,1422,1283,1459,1546,1329,1398,1452,1381,1490,1496,1492,1298,1568,1371,1315,1389,1345,1345,1515,1329,1444,1712,1402,1449,1372,1316,1527,1619,1429,1304,1360,1693,1435,1532,1462,1560,1516,1363
1447,1373,1324,1251,1378,1302,1214,1471,1257,1230,1260,1453,1428,1123,1299,1385,1169,1238,1292,1387,1330,1335,1332,1137,1408,1378,1353,1389,1352,1351,1522,1169,1284,1342,1242,1288,1379,1156,1367,1681,1269,1144,1200,1323,1275,1538,1302,1400,1355,1202
1480,1405,1356,1283,1411,1335,1246,1504,1290,1263,1293,1485,1461,1156,1331,1418,1201,1271,1324,1420,1362,1368,1364,1170,1441,1410,1386,1421,1384,1384,1554,1201,1316,1375,1274,1321,1411,1188,1400,1713,1302,1176,1232,1355,1307,1571,1335,1433,1388,1235
1432,1357,1308,1235,1362,1287,1198,1455,1241,1215,1244,1437,1412,1107,1283,1370,1153,1222,1276,1371,1314,1320,1316,1122,1392,1362,1338,1373,1336,1335,1506,1153,1268,1326,1226,1272,1363,1140,1351,1665,1253,1128,1184,1307,1259,1522,1286,1384,1340,1186
1453,1378,1329,1256,1384,1308,1219,1477,1263,1236,1266,1458,1434,1129,1304,1391,1174,1244,1297,1393,1335,1341,1337,1143,1414,1383,1359,1395,1357,1357,1527,1174,1289,1348,1247,1294,1384,1161,1373,1687,1275,1149,1206,1328,1280,1544,1308,1406,1361,1208
1379,1471,1422,1349,1309,1400,1311,1402,1355,1328,1358,1384,1359,1221,1397,1483,1267,1336,1390,1318,1427,1433,1429,1235,1506,1309,1253,1326,1283,1282,1453,1266,1381,1649,1339,1386,1310,1254,1465,1556,1367,1242,1298,1630,1372,1469,1400,1498,1453,1300
1498,1424,1375,1302,1429,1353,1264,1522,1308,1281,1311,1504,1479,1174,1350,1436,1219,1289,1343,1438,1380,1386,1382,1188,1459,1428,1404,1440,1402,1402,1572,1219,1334,1393,1292,1339,1429,1206,1418,1732,1320,1194,1251,1373,1325,1589,1353,1451,1406,1253
1263,1355,1306,1233,1194,1285,1196,1287,1239,1213,1242,1268,1244,1105,1281,1368,1151,1220,1274,1203,1312,1318,1314,1120,1390,1193,1137,1211,1167,1167,1337,1151,1266,1534,1224,1271,1194,1138,1349,1441,1251,1126,1182,1515,1257,1354,1284,1382,1338,1185
1177,1269,1220,1147,1107,1198,1109,1200,1153,1126,1156,1182,1157,1019,1195,1281,1065,1134,1188,1116,1225,1231,1227,1033,1304,1107,1051,1124,1081,1080,1251,1064,1179,1448,1138,1184,1108,1052,1263,1354,1165,1040,1096,1428,1170,1267,1198,1296,1251,1098
1408,1500,1451,1378,1339,1430,1341,1432,1384,1358,1387,1414,1389,1251,1426,1513,1296,1365,1419,1348,1457,1463,1459,1265,1536,1338,1283,1356,1312,1312,1482,1296,1411,1679,1369,1416,1339,1283,1494,1586,1396,1271,1327,1660,1402,1499,1430,1527,1483,1330
1473,1399,1350,1277,1404,1328,1239,1497,1283,1256,1286,1479,1454,1149,1325,1411,1194,1264,1318,1413,1355,1361,1357,1163,1434,1403,1379,1415,1377,1377,1547,1194,1309,1368,1267,1314,1404,1181,1393,1707,1295,1169,1226,1348,1300,1564,1328,1426,1381,1228
1303,1395,1346,1273,1234,1325,1236,1327,1279,1253,1283,1309,1284,1146,1321,1408,1191,1261,1314,1243,1352,1358,1354,1160,1431,1233,1178,1251,1207,1207,1377,1191,1306,1574,1264,1311,1234,1178,1390,1481,1291,1166,1222,1555,1297,1394,1325,1423,1378,1225
1262,1354,1305,1232,1193,1284,1195,1286,1238,1212,1242,1268,1243,1105,1280,1367,1150,1220,1273,1202,1311,1317,1313,1119,1390,1192,1137,1210,1166,1166,1336,1150,1265,1533,1223,1270,1193,1137,1349,1440,1250,1125,1181,1514,1256,1353,1284,1382,1337,1184
1462,1387,1338,1265,1392,1317,1228,1486,1271,1245,1274,1467,1442,1137,1313,1400,1183,1252,1306,1402,1344,1350,1346,1152,1422,1392,1368,1403,1366,1366,1536,1183,1298,1328,1256,1303,1393,1170,1381,1695,1283,1158,1214,1337,1289,1552,1316,1414,1370,1217
1187,1279,1230,1157,1117,1208,1119,1210,1163,1136,1166,1192,1167,1029,1205,1291,1074,1144,1198,1126,1235,1241,1237,1043,1314,1117,1061,1134,1091,1090,1261,1074,1189,1457,1147,1194,1118,1061,1273,1364,1175,1049,1106,1438,1180,1277,1208,1306,1261,1108
1499,1424,1375,1302,1429,1354,1265,1523,1308,1282,1311,1504,1479,1174,1350,1437,1220,1289,1343,1439,1381,1387,1383,1189,1459,1429,1405,1440,1403,1403,1573,1220,1298,1365,1293,1340,1430,1207,1418,1732,1320,1195,1251,1362,1326,1589,1353,1451,1407,1254
1368,1460,1411,1338,1298,1389,1300,1391,1344,1317,1347,1373,1348,1210,1386,1472,1256,1325,1379,1307,1416,1422,1418,1224,1495,1298,1242,1315,1272,1271,1442,1255,1370,1638,1328,1375,1299,1242,1454,1545,1356,1230,1287,1619,1361,1458,1389,1487,1442,1289
1441,1533,1484,1411,1372,1463,1374,1465,1417,1391,1420,1446,1422,1283,1459,1546,1329,1398,1452,1381,1490,1496,1492,1298,1568,1371,1315,1389,1345,1345,1515,1329,1444,1712,1402,1449,1372,1316,1527,1619,1429,1304,1360,1693,1435,1532,1462,1560,1516,1363
1498,1424,1375,1302,1429,1353,1264,1522,1308,1281,1311,1504,1479,1174,1350,1436,1219,1289,1343,1438,1380,1386,1382,1188,1459,1428,1404,1440,1402,1402,1572,1219,1334,1393,1292,1339,1429,1206,1418,1732,1320,1194,1251,1373,1325,1589,1353,1451,1406,1253
1420,1345,1297,1224,1351,1275,1186,1444,1230,1203,1233,1426,1401,1096,1272,1358,1141,1211,1265,1360,1302,1308,1304,1110,1381,1350,1326,1362,1324,1324,1494,1141,1220,1315,1214,1261,1351,1128,1340,1654,1242,1116,1173,1295,1247,1511,1275,1373,1328,1175
1430,1355,1306,1233,1361,1285,1196,1454,1240,1213,1243,1435,1411,1106,1281,1368,1151,1221,1274,1370,1312,1318,1314,1120,1391,1360,1336,1372,1334,1334,1504,1151,1229,1297,1224,1271,1361,1138,1350,1664,1252,1126,1183,1305,1257,1521,1285,1383,1338,1185
1258,1350,1301,1228,1189,1280,1191,1282,1234,1208,1237,1264,1239,1101,1276,1363,1146,1215,1269,1198,1307,1313,1309,1115,1386,1188,1133,1206,1162,1162,1332,1146,1261,1529,1219,1266,1189,1133,1344,1436,1246,1121,1177,1510,1252,1349,1280,1377,1333,1180
1249,1341,1292,1219,1180,1271,1182,1273,1225,1199,1228,1254,1230,1091,1267,1354,1137,1206,1260,1189,1298,1304,1300,1106,1376,1179,1123,1197,1153,1153,1323,1137,1252,1520,1210,1257,1180,1124,1335,1427,1237,1112,1168,1501,1243,1340,1270,1368,1324,1171
1452,1377,1328,1255,1382,1307,1218,1476,1261,1235,1264,1457,1432,1127,1303,1390,1173,1242,1296,1391,1334,1340,1336,1142,1412,1382,1358,1393,1356,1356,1526,1173,1288,1346,1246,1293,1383,1160,1371,1685,1273,1148,1204,1327,1279,1542,1306,1404,1360,1207
1431,1357,1308,1235,1362,1286,1197,1455,1241,1214,1244,1437,1412,1107,1283,1369,1153,1222,1276,1371,1313,1319,1315,1121,1392,1361,1337,1373,1335,1335,1505,1152,1267,1326,1225,1272,1362,1139,1351,1665,1253,1127,1184,1306,1258,1522,1286,1384,1339,1186
1402,1494,1445,1372,1333,1424,1335,1426,1379,1352,1382,1408,1383,1245,1420,1507,1290,1360,1413,1342,1451,1457,1453,1259,1530,1333,1277,1350,1306,1306,1476,1290,1405,1673,1363,1410,1333,1277,1489,1580,1391,1265,1322,1654,1396,1493,1424,1522,1477,1324
1525,1451,1402,1329,1456,1380,1291,1549,1335,1308,1338,1531,1506,1201,1377,1463,1247,1316,1370,1465,1408,1413,1410,1215,1486,1456,1431,1467,1429,1429,1600,1247,1362,1420,1320,1366,1457,1234,1445,1759,1347,1222,1278,1401,1352,1616,1380,1478,1433,1280
1471,1396,1347,1274,1401,1326,1237,1495,1280,1254,1283,1476,1451,1146,1322,1409,1192,1261,1315,1410,1353,1359,1355,1161,1431,1401,1377,1412,1375,1375,1545,1192,1307,1365,1265,1312,1402,1179,1390,1704,1292,1167,1223,1346,1298,1561,1325,1423,1379,1226
1476,1402,1353,1280,1407,1331,1242,1500,1286,1259,1289,1482,1457,1152,1328,1414,1198,1267,1321,1416,1358,1364,1360,1166,1437,1407,1382,1418,1380,1380,1550,1197,1312,1371,1270,1317,1407,1185,1396,1710,1298,1173,1229,1351,1303,1567,1331,1429,1384,1231
1256,1348,1299,1226,1187,1278,1189,1280,1233,1206,1236,1262,1237,1099,1274,1361,1144,1214,1267,1196,1305,1311,1307,1113,1384,1187,1131,1204,1160,1160,1330,1144,1259,1527,1217,1264,1188,1131,1343,1434,1245,1119,1176,1508,1250,1347,1278,1376,1331,1178
