0,1,2,3,4,5,6,7,8,9,10,11,12,13,14,15,16,17,18,19,20,21,22,23,24,25,26,27,28,29,30,31,32,33,34,35,36,37,38,39,40,41,42,43,44,45,46,47,48,49
1901,2146,2109,2024,1965,2075,1916,1895,2030,1956,1771,1877,1852,1896,2072,2167,1942,1960,2065,1811,2085,2108,2105,1910,2130,1981,1956,1972,1954,1954,1934,1942,1969,2036,1927,2061,1981,1929,2053,1984,2042,1632,1599,2096,1977,1951,2037,2122,2128,1975
1869,2114,2077,1992,1933,2044,1884,1863,1999,1924,1740,1846,1821,1865,1989,2135,1910,1929,2033,1780,2053,2077,2073,1879,2150,1949,1925,1940,1923,1923,1903,1910,1938,2033,1896,2030,1950,1897,2021,1953,2011,1601,1568,2064,1945,1919,2006,2091,2097,1944
1877,2122,2085,2000,1941,2052,1892,1871,2006,1932,1748,1853,1829,1872,1997,2143,1918,1937,2041,1788,2061,2085,2081,1887,2157,1957,1933,1948,1931,1931,1911,1918,1945,2040,1903,2038,1958,1905,2029,1961,2018,1609,1575,2072,1953,1927,2014,2099,2105,1952
1861,2106,2069,1984,1925,2036,1876,1856,1991,1916,1732,1838,1813,1857,2032,2127,1902,1921,2025,1772,2045,2069,2065,1871,2091,1941,1917,1932,1915,1915,1895,1902,1930,1997,1888,2022,1942,1889,2013,1945,2003,1593,1560,2056,1938,1911,1998,2083,2089,1936
1881,2126,2089,2004,1945,2056,1896,1875,2010,1936,1752,1857,1833,1876,2052,2147,1922,1941,2045,1792,2065,2089,2085,1891,2111,1961,1937,1952,1935,1935,1915,1922,1949,2045,1907,2042,1962,1909,2033,1965,2022,1613,1579,2076,1957,1931,2018,2103,2109,1956
1867,2111,2074,1990,1930,2041,1882,1861,1996,1922,1737,1843,1818,1862,1987,2132,1907,1926,2031,1777,2050,2074,2070,1876,2147,1946,1922,1937,1920,1920,1900,1907,1935,2030,1893,2027,1947,1894,2018,1950,2008,1598,1565,2061,1943,1916,2003,2088,2094,1941
1856,2101,2064,1979,1920,2031,1871,1850,1985,1911,1727,1832,1807,1851,2027,2122,1897,1915,2020,1767,2040,2013,2060,1866,2085,1936,1911,1927,1910,1909,1889,1897,1924,1991,1882,2016,1937,1884,2008,1940,1997,1588,1554,2051,1932,1906,1993,2077,2084,1930
1866,2111,2074,1989,1930,2041,1881,1860,1995,1921,1736,1842,1817,1861,1986,2132,1907,1925,2030,1776,2050,2074,2070,1875,2146,1946,1921,1937,1920,1919,1899,1907,1934,2029,1892,2026,1947,1894,2018,1950,2007,1598,1564,2061,1942,1916,2003,2087,2094,1940
1886,2131,2094,2009,1950,2061,1901,1880,2015,1941,1757,1862,1837,1881,2057,2152,1927,1945,2050,1797,2070,2094,2090,1896,2115,1966,1941,1957,1940,1939,1919,1927,1954,2049,1912,2046,1967,1914,2038,1970,2027,1618,1584,2081,1962,1936,2023,2107,2114,1960
1901,2146,2109,2024,1965,2075,1916,1895,2030,1956,1771,1877,1852,1896,2072,2167,1942,1960,2065,1811,2085,2108,2105,1910,2130,1981,1956,1972,1954,1954,1934,1942,1969,2036,1927,2061,1981,1929,2053,1984,2042,1632,1599,2096,1977,1951,2037,2122,2128,1975
1851,2096,2059,1974,1914,2025,1963,1845,1980,1906,1721,1827,1802,1846,1971,2117,1892,1910,2015,1761,2035,2007,2055,1860,2131,1931,1906,1922,1904,1904,1884,1892,1919,2014,1877,2011,1931,1879,2003,1934,1992,1582,1549,2046,2024,1901,1987,2123,2078,1925
1853,2098,2061,1976,1917,2028,1869,1848,1983,1909,1724,1830,1805,1849,1974,2119,1894,1913,2018,1764,2037,2061,2057,1863,2134,1933,1909,1924,1907,1907,1887,1894,1922,2017,1880,2014,1934,1881,2005,1937,1995,1585,1552,2048,2026,1903,1990,2075,2081,1928
1898,2143,2106,2021,1962,2072,1913,1892,2027,1953,1768,1874,1849,1893,2069,2164,1939,1957,2062,1808,2082,2105,2102,1907,2127,1978,1953,1969,1951,1951,1931,1939,1966,2061,1924,2058,1979,1926,2050,1982,2039,1630,1596,2093,1974,1948,2034,2119,2125,1921
1861,2106,2068,1984,1924,2035,1876,1855,1990,1916,1731,1837,1812,1856,1981,2126,1902,1920,2025,1771,2045,2068,2064,1870,2141,1940,1916,1932,1914,1914,1894,1901,1929,2024,1887,2021,1941,1889,2013,1944,2002,1592,1559,2055,1937,1911,1997,2082,2088,1935
1883,2128,2091,2006,1947,2058,1899,1878,2013,1938,1754,1860,1835,1879,2054,2149,1924,1943,2047,1794,2067,2091,2087,1893,2113,1963,1939,1954,1937,1937,1917,1924,1952,2047,1910,2044,1964,1911,2035,1967,2025,1615,1582,2078,1960,1933,2020,2105,2111,1958
1877,2122,2085,2000,1941,2052,1892,1871,2007,1932,1748,1854,1829,1873,2048,2143,1918,1937,2041,1788,2061,2085,2081,1887,2107,1957,1933,1948,1931,1931,1911,1918,1945,2041,1904,2038,1958,1905,2029,1961,2019,1609,1575,2072,1953,1927,2014,2099,2105,1952
1900,2145,2107,2023,1963,2074,1915,1894,2029,1955,1770,1876,1851,1895,2071,2165,1940,1959,2064,1810,2083,2107,2103,1909,2129,1979,1955,1971,1953,1953,1933,1940,1968,2063,1926,2060,1980,1927,2052,1983,2041,1631,1598,2094,1976,1949,2036,2121,2127,1923
1870,2115,2077,1993,1933,2044,1885,1864,1999,1925,1740,1846,1821,1865,1990,2135,1911,1929,2034,1780,2053,2077,2073,1879,2099,1949,1925,1941,1923,1923,1903,1910,1938,2033,1896,2030,1950,1898,2022,1953,2011,1601,1568,2064,1946,1919,2006,2091,2097,1944
1845,2090,2053,1968,1909,2020,1957,1839,1975,1900,1716,1822,1797,1841,2016,2111,1886,1905,2009,1756,2029,2002,2049,1855,2126,1925,1901,1916,1899,1899,1879,1886,1913,2009,1872,2006,1926,1873,1997,1929,1987,1577,1543,1989,2018,1895,1982,2118,2073,1920
1884,2129,2092,2007,1948,2059,1899,1878,2013,1939,1755,1860,1836,1879,2055,2150,1925,1943,2048,1795,2068,2092,2088,1894,2113,1964,1940,1955,1938,1937,1917,1925,1952,2047,1910,2045,1965,1912,2036,1968,2025,1616,1582,2079,1960,1934,2021,2105,2112,1959
1880,2125,2088,2003,1944,2055,1895,1874,2009,1935,1751,1856,1832,1876,2051,2146,1921,1940,2044,1791,2064,2088,2084,1890,2110,1960,1936,1951,1934,1934,1914,1921,1948,2044,1906,2041,1961,1908,2032,1964,2021,1612,1578,2075,1956,1930,2017,2102,2108,1955
1880,2125,2088,2003,1943,2054,1895,1874,2009,1935,1750,1856,1831,1875,2000,2145,1921,1939,2044,1790,2064,2087,2084,1889,2160,1960,1935,1951,1933,1933,1913,1921,1948,2043,1906,2040,1960,1908,2032,1963,2021,1611,1578,2075,1956,1930,2016,2101,2107,1954
1871,2116,2079,1994,1935,2045,1886,1865,2000,1926,1741,1847,1822,1866,1991,2137,1912,1930,2035,1781,2055,2078,2075,1880,2151,1951,1926,1942,1924,1924,1904,1912,1939,2034,1897,2031,1952,1899,2023,1954,2012,1603,1569,2066,1947,1921,2007,2092,2098,1945
1877,2122,2084,2000,1940,2051,1892,1871,2006,1932,1747,1853,1828,1872,2048,2142,1918,1936,2041,1787,2061,2084,2080,1886,2106,1956,1932,1948,1930,1930,1910,1917,1945,2012,1903,2037,1957,1905,2029,1960,2018,1608,1575,2071,1953,1927,2013,2098,2104,1951
1869,2114,2077,1992,1933,2044,1884,1863,1999,1924,1740,1846,1821,1865,1989,2135,1910,1929,2033,1780,2053,2077,2073,1879,2150,1949,1925,1940,1923,1923,1903,1910,1938,2033,1896,2030,1950,1897,2021,1953,2011,1601,1568,2064,1945,1919,2006,2091,2097,1944
1865,2110,2073,1988,1929,2040,1880,1859,1994,1920,1736,1841,1817,1860,1985,2131,1906,1925,2029,1776,2049,2073,2069,1875,2145,1945,1921,1936,1919,1919,1899,1906,1933,2028,1891,2026,1946,1893,2017,1949,2006,1597,1563,2060,1941,1915,2002,2087,2093,1940
1864,2109,2072,1987,1928,2039,1879,1858,1993,1919,1735,1841,1816,1860,1984,2130,1905,1924,2028,1775,2048,2072,2068,1874,2145,1944,1920,1935,1918,1918,1898,1905,1932,2028,1891,2025,1945,1892,2016,1948,2005,1596,1562,2059,1940,1914,2001,2086,2092,1939
1878,2123,2086,2001,1942,2053,1893,1872,2007,1933,1749,1854,1830,1873,2049,2144,1919,1937,2042,1789,2062,2086,2082,1888,2108,1958,1934,1949,1932,1932,1911,1919,1946,2041,1904,2039,1959,1906,2030,1962,2019,1610,1576,2073,1954,1928,2015,2100,2106,1953
1860,2105,2068,1983,1924,2035,1875,1854,1989,1915,1731,1836,1812,1856,1980,2126,1901,1920,2024,1771,2044,2068,2064,1870,2141,1940,1916,1931,1914,1914,1894,1901,1928,2024,1886,2021,1941,1888,2012,1944,2001,1592,1558,2055,1936,1910,1997,2082,2088,1935
1846,2091,2054,1969,1910,2021,1958,1840,1975,1901,1717,1822,1797,1841,2017,2112,1887,1905,2010,1757,2030,2003,2050,1856,2126,1926,1901,1917,1900,1899,1879,1887,1914,2009,1872,2007,1927,1874,1998,1930,1987,1578,1544,1990,2019,1896,1983,2118,2074,1920
1892,2136,2099,2015,1955,2066,1907,1886,2021,1947,1762,1868,1843,1887,2063,2157,1932,1951,2056,1802,2075,2099,2044,1850,2121,1971,1947,1962,1945,1945,1925,1932,1960,2027,1918,2052,1972,1919,2044,1975,2033,1623,1590,2086,1968,1941,2028,2113,2119,1966
1854,2099,2062,1977,1918,2029,1869,1848,1984,1909,1725,1831,1806,1850,1974,2120,1895,1914,2018,1765,2038,2062,2058,1864,2135,1934,1910,1925,1908,1908,1888,1895,1922,2018,1881,2015,1935,1882,2006,1938,1996,1586,1552,2049,1930,1904,1991,2076,2082,1929
1869,2114,2077,1992,1933,2044,1884,1863,1999,1924,1740,1846,1821,1865,1989,2135,1910,1929,2033,1780,2053,2077,2073,1879,2150,1949,1925,1940,1923,1923,1903,1910,1938,2033,1896,2030,1950,1897,2021,1953,2011,1601,1568,2064,1945,1919,2006,2091,2097,1944
2009,2254,2217,2132,2073,2184,2121,2003,2138,2064,1880,1985,1960,2004,2180,2275,2050,2119,2173,1920,2193,2217,2213,2018,2289,2089,2064,2080,2063,2062,2042,2050,2128,2195,2035,2169,2090,2037,2161,2093,2150,1741,1707,2204,2182,2059,2146,2281,2237,2083
1869,2114,2077,1992,1933,2043,1884,1863,1998,1924,1739,1845,1820,1864,1989,2135,1910,1928,2033,1779,2053,2076,2073,1878,2149,1949,1924,1940,1922,1922,1902,1910,1937,2032,1895,2029,1949,1897,2021,1952,2010,1600,1567,2064,1945,1919,2005,2090,2096,1943
2008,2253,2216,2131,2071,2182,2120,2002,2137,2063,1878,1984,1959,2003,2179,2273,2049,2118,2172,1918,2192,2215,2212,2017,2288,2088,2063,2079,2061,2061,2041,2049,2127,2194,2034,2168,2088,2036,2160,2091,2149,1739,1706,2203,2181,2058,2144,2280,2235,2082
1888,2133,2096,2011,1952,2063,1903,1882,2017,1943,1758,1864,1839,1883,2059,2154,1929,1947,2052,1798,2072,2095,2041,1847,2117,1968,1943,1959,1942,1941,1921,1929,1956,2023,1914,2048,1969,1916,2040,1972,2029,1620,1586,2083,1964,1938,2024,2109,2116,1962
1874,2119,2082,1997,1938,2048,1889,1868,2003,1929,1744,1850,1825,1869,1994,2140,1915,1933,2038,1784,2058,2081,2078,1883,2154,1954,1929,1945,1927,1927,1907,1915,1942,2037,1900,2034,1954,1902,2026,1957,2015,1605,1572,2069,1950,1924,2010,2095,2101,1948
1872,2117,2080,1995,1936,2047,1887,1866,2001,1927,1743,1848,1824,1867,2043,2138,1913,1931,2036,1783,2056,2080,2076,1882,2102,1952,1928,1943,1926,1926,1905,1913,1940,2035,1898,2033,1953,1900,2024,1956,2013,1604,1570,2067,1948,1922,2009,2094,2100,1947
1882,2127,2090,2005,1946,2057,1897,1876,2011,1937,1753,1858,1833,1877,2002,2148,1923,1941,2046,1793,2066,2090,2086,1892,2162,1962,1937,1953,1936,1935,1915,1923,1950,2045,1908,2043,1963,1910,2034,1966,2023,1614,1580,2077,1958,1932,2019,2103,2110,1956
1876,2121,2084,1999,1940,2051,1891,1870,2005,1931,1746,1852,1827,1871,1996,2142,1917,1935,2040,1786,2060,2084,2080,1885,2156,1956,1931,1947,1930,1929,1909,1917,1944,2039,1902,2036,1957,1904,2028,1960,2017,1608,1574,2071,1952,1926,2013,2097,2104,1950
1868,2113,2076,1991,1932,2043,1883,1862,1997,1923,1738,1844,1819,1863,2039,2134,1909,1927,2032,1778,2052,2076,2072,1877,2148,1948,1923,1939,1922,1921,1901,1909,1936,2031,1894,2028,1949,1896,2020,1952,2009,1600,1566,2063,1944,1918,2005,2089,2096,1942
1858,2103,2066,1981,1922,2033,1873,1852,1987,1913,1729,1835,1810,1854,2029,2124,1899,1918,2022,1769,2042,2066,2062,1868,2088,1938,1914,1929,1912,1912,1892,1899,1926,1994,1885,2019,1939,1886,2010,1942,1999,1590,1556,2053,1934,1908,1995,2080,2086,1933
1853,2098,2061,1976,1917,2028,1868,1847,1982,1908,1723,1829,1804,1848,2024,2119,1894,1912,2017,1763,2037,2010,2057,1862,2082,1933,1908,1924,1907,1906,1886,1894,1921,1988,1879,2013,1934,1881,2005,1937,1994,1585,1551,2048,1929,1903,1990,2125,2081,1927
1887,2132,2095,2010,1951,2062,1902,1881,2016,1942,1758,1863,1839,1882,2058,2153,1928,1947,2051,1798,2071,2095,2091,1897,2117,1967,1943,1958,1941,1941,1921,1928,1955,2051,1913,2048,1968,1915,2039,1971,2028,1619,1585,2082,1963,1937,2024,2109,2115,1962
1850,2095,2058,1973,1914,2025,1865,1845,1980,1905,1721,1827,1802,1846,2021,2116,1891,1910,2014,1761,2034,2007,2054,1860,2080,1930,1906,1921,1904,1904,1884,1891,1919,1986,1877,2011,1931,1878,2002,1934,1992,1582,1549,2045,1927,1900,1987,2123,2078,1925
1865,2110,2073,1988,1929,2040,1881,1860,1995,1920,1736,1842,1817,1861,2036,2131,1906,1925,2029,1776,2049,2073,2069,1875,2095,1945,1921,1936,1919,1919,1899,1906,1934,2029,1892,2026,1946,1893,2017,1949,2007,1597,1564,2060,1942,1915,2002,2087,2093,1940
1875,2120,2082,1998,1938,2049,1890,1869,2004,1930,1745,1851,1826,1870,1995,2140,1916,1934,2039,1785,2058,2082,2078,1884,2155,1954,1930,1946,1928,1928,1908,1915,1943,2038,1901,2035,1955,1903,2027,1958,2016,1606,1573,2069,1951,1924,2011,2096,2102,1949
1898,2143,2106,2021,1961,2072,1913,1892,2027,1953,1768,1874,1849,1893,2069,2163,1939,1957,2062,1808,2082,2105,2101,1907,2127,1978,1953,1969,1951,1951,1931,1938,1966,2061,1924,2058,1978,1926,2050,1981,2039,1629,1596,2093,1974,1948,2034,2119,2125,1921
2007,2252,2215,2130,2071,2182,2119,2001,2136,2062,1877,1983,1958,2002,2178,2273,2048,2117,2171,1917,2191,2215,2211,2016,2287,2087,2062,2078,2061,2060,2040,2048,2126,2193,2033,2167,2088,2035,2159,2091,2148,1739,1705,2202,2180,2057,2144,2279,2235,2081
