0,1,2,3,4,5,6,7,8,9,10,11,12,13,14,15,16,17,18,19,20,21,22,23,24,25,26,27,28,29,30,31,32,33,34,35,36,37,38,39,40,41,42,43,44,45,46,47,48,49
1789,1832,1778,1657,1719,1703,1837,1813,1658,1729,1881,1883,1858,1624,1738,1875,1667,1719,1692,1817,1828,1817,1780,1636,1640,1756,1653,1727,1742,1742,1863,1667,1690,1603,1701,1692,1757,1654,1865,2022,1707,1765,1821,1628,1796,1879,1800,1830,1845,1603
1820,1845,1810,1689,1751,1735,1869,1844,1689,1760,1855,1881,1856,1656,1769,1906,1699,1733,1724,1815,1859,1830,1775,1667,1671,1788,1685,1758,1774,1774,1894,1698,1722,1635,1733,1723,1789,1686,1897,2053,1738,1739,1795,1659,1914,1911,1832,1862,1876,1634
1759,1784,1748,1628,1690,1673,1807,1783,1628,1699,1862,1853,1828,1595,1708,1845,1637,1672,1663,1787,1798,1769,1714,1606,1610,1727,1624,1697,1712,1712,1833,1637,1660,1574,1671,1662,1728,1624,1835,1993,1677,1746,1802,1598,1767,1850,1771,1801,1815,1573
1735,1760,1724,1603,1665,1649,1783,1759,1604,1675,1882,1829,1804,1570,1684,1821,1613,1647,1639,1763,1774,1745,1690,1582,1586,1702,1599,1673,1688,1688,1809,1613,1636,1549,1647,1638,1703,1600,1811,1968,1653,1817,1818,1574,1742,1825,1746,1776,1791,1549
1752,1777,1741,1620,1682,1666,1800,1776,1621,1692,1889,1846,1821,1587,1701,1838,1630,1664,1656,1780,1791,1762,1707,1599,1603,1719,1616,1690,1705,1705,1826,1630,1653,1566,1664,1655,1720,1617,1828,1985,1670,1773,1835,1591,1759,1842,1763,1793,1808,1566
1749,1774,1738,1617,1679,1663,1797,1772,1618,1689,1896,1843,1818,1584,1698,1835,1627,1661,1652,1777,1788,1759,1703,1595,1599,1716,1613,1686,1702,1702,1823,1627,1650,1563,1661,1652,1717,1614,1825,1982,1667,1866,1832,1588,1756,1839,1760,1790,1805,1563
1790,1815,1780,1659,1721,1704,1839,1814,1659,1730,1932,1884,1859,1626,1739,1876,1668,1703,1694,1818,1829,1800,1745,1637,1641,1758,1655,1728,1744,1743,1864,1668,1691,1605,1702,1693,1759,1655,1867,2024,1708,1816,1872,1629,1798,1881,1802,1832,1846,1604
1736,1761,1725,1604,1666,1650,1784,1759,1605,1676,1915,1830,1805,1571,1685,1822,1614,1648,1639,1764,1775,1746,1690,1582,1586,1703,1600,1674,1689,1689,1810,1614,1637,1550,1648,1639,1704,1601,1812,1969,1654,1799,1819,1575,1743,1826,1747,1777,1792,1550
1767,1792,1757,1636,1698,1682,1816,1791,1636,1707,1915,1861,1836,1603,1716,1853,1646,1680,1671,1796,1806,1777,1722,1614,1618,1735,1632,1705,1721,1721,1841,1645,1669,1582,1680,1670,1736,1632,1844,2001,1685,1884,1851,1606,1775,1858,1779,1809,1823,1581
1762,1787,1751,1630,1692,1676,1810,1786,1631,1702,1884,1856,1831,1597,1711,1848,1640,1674,1666,1790,1801,1772,1717,1609,1613,1730,1626,1700,1715,1715,1836,1640,1663,1576,1674,1665,1730,1627,1838,1995,1680,1768,1824,1601,1769,1852,1773,1803,1818,1576
1746,1771,1735,1614,1676,1660,1794,1769,1614,1686,1893,1840,1815,1581,1695,1832,1624,1658,1649,1774,1785,1755,1700,1592,1596,1713,1610,1683,1699,1699,1820,1624,1647,1560,1658,1648,1714,1611,1822,1979,1664,1803,1829,1585,1753,1836,1757,1787,1802,1560
1702,1727,1692,1571,1633,1617,1751,1726,1571,1642,1850,1796,1772,1538,1652,1788,1581,1615,1606,1731,1741,1712,1657,1549,1553,1670,1567,1640,1656,1656,1777,1580,1604,1517,1615,1605,1671,1568,1779,1936,1620,1819,1786,1541,1710,1793,1714,1744,1758,1517
1818,1843,1808,1687,1749,1733,1867,1842,1687,1758,1969,1912,1888,1654,1768,1904,1697,1731,1722,1847,1857,1828,1810,1665,1669,1786,1683,1756,1772,1772,1893,1696,1720,1633,1731,1721,1787,1684,1895,2052,1736,1852,1902,1657,1826,1909,1830,1860,1874,1633
1364,1389,1353,1232,1294,1278,1412,1388,1233,1304,1511,1458,1433,1199,1313,1450,1242,1276,1267,1392,1403,1374,1318,1211,1215,1331,1228,1302,1317,1317,1438,1242,1265,1178,1276,1267,1332,1229,1440,1597,1282,1481,1447,1203,1371,1454,1375,1405,1420,1178
1740,1765,1729,1609,1671,1654,1789,1764,1609,1680,1887,1834,1809,1576,1689,1826,1618,1653,1644,1768,1779,1750,1695,1587,1591,1708,1605,1678,1694,1693,1814,1618,1641,1555,1652,1643,1709,1605,1817,1974,1658,1822,1824,1579,1748,1831,1752,1782,1796,1554
1816,1841,1806,1685,1747,1731,1865,1840,1685,1756,1964,1910,1885,1652,1765,1902,1694,1729,1720,1844,1855,1826,1771,1663,1667,1784,1681,1754,1770,1770,1890,1694,1718,1631,1729,1719,1785,1681,1893,2050,1734,1879,1900,1655,1824,1907,1828,1858,1872,1630
1941,1966,1930,1809,1871,1855,1989,1965,1810,1881,2044,2035,2010,1777,1890,2027,1819,1853,1845,1969,1980,1951,1896,1788,1792,1909,1805,1879,1894,1894,2015,1819,1842,1755,1853,1844,1909,1806,2017,2174,1859,1928,1984,1780,1948,2031,1952,1982,1997,1755
1750,1775,1740,1619,1681,1664,1799,1774,1619,1690,1883,1844,1819,1586,1699,1859,1628,1663,1654,1778,1789,1783,1705,1597,1601,1718,1615,1688,1704,1703,1824,1628,1651,1565,1662,1653,1719,1615,1827,1984,1668,1766,1823,1589,1758,1841,1762,1792,1806,1564
1759,1783,1748,1627,1689,1673,1807,1782,1627,1698,1822,1852,1828,1594,1708,1844,1637,1671,1662,1787,1797,1768,1713,1605,1609,1726,1623,1696,1712,1712,1833,1636,1660,1573,1671,1661,1727,1624,1835,1992,1676,1705,1762,1597,1766,1849,1770,1800,1814,1573
1798,1823,1787,1666,1728,1712,1846,1822,1667,1738,1979,1892,1867,1633,1747,1884,1676,1710,1702,1826,1837,1808,1753,1645,1649,1766,1662,1736,1751,1751,1872,1676,1699,1612,1710,1701,1766,1663,1874,2031,1716,1863,1881,1637,1805,1888,1809,1839,1854,1612
1762,1787,1752,1631,1693,1677,1811,1786,1631,1702,1884,1856,1831,1598,1711,1848,1640,1675,1666,1790,1801,1772,1717,1609,1613,1730,1627,1700,1716,1716,1836,1640,1664,1577,1675,1665,1731,1627,1839,1996,1680,1768,1824,1601,1770,1853,1774,1804,1818,1576
1761,1786,1750,1629,1691,1675,1809,1785,1630,1701,1885,1855,1830,1596,1710,1847,1639,1673,1664,1789,1800,1771,1715,1608,1612,1728,1625,1699,1714,1714,1835,1639,1662,1575,1673,1664,1729,1626,1837,1994,1679,1769,1825,1600,1768,1851,1772,1802,1817,1575
1746,1771,1736,1615,1677,1661,1795,1770,1615,1686,1925,1840,1815,1582,1695,1832,1624,1659,1650,1774,1785,1756,1701,1593,1597,1714,1611,1684,1700,1700,1820,1624,1648,1561,1659,1649,1715,1611,1823,1980,1664,1809,1830,1585,1754,1837,1758,1788,1802,1560
1759,1783,1748,1627,1689,1673,1807,1782,1627,1698,1862,1852,1828,1594,1708,1844,1637,1671,1662,1787,1797,1768,1750,1605,1609,1726,1623,1696,1712,1712,1833,1637,1660,1573,1671,1661,1727,1624,1835,1992,1676,1745,1802,1597,1766,1849,1770,1800,1814,1573
1741,1766,1731,1610,1672,1655,1790,1765,1610,1681,1889,1835,1810,1577,1690,1827,1619,1654,1645,1769,1780,1751,1732,1588,1592,1709,1606,1679,1695,1694,1815,1619,1642,1556,1653,1644,1710,1606,1818,1975,1659,1823,1825,1580,1749,1832,1753,1783,1797,1555
1829,1887,1852,1731,1760,1777,1927,1853,1731,1779,1809,1835,1810,1672,1812,1948,1717,1775,1766,1769,1878,1872,1817,1686,1713,1760,1704,1777,1733,1733,1903,1717,1764,1677,1717,1765,1760,1704,1916,2007,1781,1692,1748,1702,1868,1920,1851,1904,1919,1677
1783,1808,1772,1651,1713,1697,1831,1807,1652,1723,1871,1877,1852,1618,1732,1869,1661,1695,1687,1811,1822,1793,1738,1630,1634,1750,1647,1721,1736,1736,1857,1661,1684,1597,1695,1686,1751,1648,1859,2016,1701,1755,1811,1622,1790,1873,1794,1824,1839,1597
1767,1792,1756,1636,1698,1681,1816,1791,1636,1707,1836,1861,1836,1603,1716,1853,1645,1680,1671,1795,1806,1777,1722,1614,1618,1735,1632,1705,1721,1720,1841,1645,1668,1582,1679,1670,1736,1632,1844,2001,1685,1720,1776,1606,1775,1858,1779,1809,1823,1581
1773,1798,1762,1641,1703,1687,1821,1797,1642,1713,1876,1867,1842,1608,1722,1859,1651,1685,1677,1801,1812,1783,1728,1620,1624,1740,1637,1711,1726,1726,1847,1651,1674,1587,1685,1676,1741,1638,1849,2006,1691,1760,1816,1612,1780,1863,1784,1814,1829,1587
1768,1793,1757,1637,1699,1682,1816,1792,1637,1708,1871,1862,1837,1604,1717,1854,1646,1680,1672,1796,1807,1778,1723,1615,1619,1736,1633,1706,1721,1721,1842,1646,1669,1583,1680,1671,1736,1633,1844,2001,1686,1755,1811,1607,1776,1859,1780,1810,1824,1582
1768,1793,1757,1636,1698,1682,1816,1792,1637,1708,1871,1862,1837,1603,1717,1854,1646,1680,1672,1796,1807,1778,1723,1615,1619,1735,1632,1706,1721,1721,1842,1646,1669,1582,1680,1671,1736,1633,1844,2001,1686,1755,1811,1607,1775,1858,1779,1809,1824,1582
1774,1799,1763,1643,1705,1688,1823,1798,1643,1714,1823,1868,1843,1610,1723,1860,1652,1687,1678,1783,1813,1784,1729,1621,1625,1742,1639,1712,1728,1727,1848,1652,1675,1589,1686,1677,1743,1639,1851,2008,1692,1706,1763,1613,1782,1865,1786,1816,1830,1588
1842,1934,1885,1740,1772,1849,1827,1865,1740,1791,1821,1847,1822,1684,1860,1946,1730,1799,1838,1781,1890,1896,1826,1698,1722,1772,1716,1789,1746,1745,1916,1729,1808,1686,1730,1837,1773,1717,1928,2019,1830,1705,1761,1773,1880,1932,1863,1913,1916,1685
1664,1689,1654,1533,1595,1579,1713,1688,1533,1604,1812,1758,1733,1500,1613,1750,1542,1577,1568,1692,1703,1674,1619,1511,1515,1632,1529,1602,1618,1618,1738,1542,1566,1479,1577,1567,1633,1529,1741,1898,1582,1781,1748,1503,1672,1755,1676,1706,1720,1478
1756,1781,1746,1625,1687,1671,1805,1780,1625,1696,1904,1850,1825,1592,1705,1842,1635,1669,1660,1785,1795,1766,1711,1603,1607,1724,1621,1694,1710,1710,1830,1634,1658,1571,1669,1659,1725,1621,1833,1990,1674,1825,1840,1595,1764,1847,1768,1798,1812,1570
1853,1878,1851,1721,1793,1776,1910,1886,1722,1802,2000,1956,1922,1698,1802,1939,1740,1765,1766,1881,1892,1863,1817,1709,1704,1820,1727,1800,1816,1815,1936,1740,1754,1667,1774,1756,1821,1727,1929,2086,1780,1895,1946,1701,1870,1953,1864,1904,1909,1667
1789,1814,1779,1658,1720,1704,1838,1813,1658,1729,1864,1883,1858,1625,1738,1875,1667,1702,1693,1818,1828,1799,1744,1636,1640,1757,1654,1727,1743,1743,1863,1667,1691,1604,1702,1692,1758,1654,1866,2023,1707,1748,1804,1628,1797,1880,1801,1831,1845,1603
1772,1797,1761,1640,1702,1686,1820,1796,1641,1712,1858,1866,1841,1607,1721,1858,1650,1684,1675,1800,1811,1782,1727,1619,1623,1739,1636,1710,1725,1725,1846,1650,1673,1586,1684,1675,1740,1637,1848,2005,1690,1741,1798,1611,1779,1862,1783,1813,1828,1586
1823,1848,1812,1691,1753,1737,1871,1846,1691,1763,1973,1916,1892,1658,1772,1909,1701,1735,1726,1851,1862,1832,1814,1669,1673,1790,1687,1760,1776,1776,1897,1701,1724,1637,1735,1725,1791,1688,1899,2056,1741,1857,1906,1662,1830,1913,1834,1864,1879,1637
1751,1776,1740,1619,1681,1665,1799,1774,1619,1691,1898,1845,1820,1586,1700,1837,1629,1663,1654,1779,1790,1760,1705,1597,1601,1718,1615,1688,1704,1704,1825,1629,1652,1565,1663,1653,1719,1616,1827,1984,1669,1819,1834,1590,1758,1841,1762,1792,1807,1565
1772,1797,1761,1641,1703,1686,1820,1796,1641,1712,1882,1866,1841,1608,1721,1858,1650,1685,1676,1800,1811,1782,1727,1619,1623,1740,1637,1710,1725,1725,1846,1650,1673,1587,1684,1675,1741,1637,1848,2006,1690,1766,1822,1611,1780,1863,1784,1814,1828,1586
1790,1815,1779,1658,1720,1704,1838,1813,1658,1730,1884,1884,1859,1625,1739,1876,1668,1702,1693,1818,1829,1799,1744,1636,1640,1757,1654,1727,1743,1743,1864,1668,1691,1604,1702,1692,1758,1655,1866,2023,1708,1768,1824,1629,1797,1880,1801,1831,1846,1604
1778,1803,1768,1647,1709,1692,1827,1802,1647,1718,1926,1872,1847,1614,1727,1864,1656,1691,1682,1806,1817,1788,1733,1625,1629,1746,1643,1716,1732,1731,1852,1656,1679,1593,1690,1681,1747,1643,1855,2012,1696,1840,1862,1617,1786,1869,1790,1820,1834,1592
1791,1816,1780,1659,1721,1705,1839,1815,1660,1731,1885,1885,1860,1626,1740,1877,1669,1703,1694,1819,1830,1801,1745,1638,1642,1758,1655,1729,1744,1744,1865,1669,1692,1605,1703,1694,1759,1656,1867,2024,1709,1769,1825,1630,1798,1881,1802,1832,1847,1605
1694,1718,1683,1562,1624,1608,1742,1717,1562,1633,1841,1787,1763,1529,1643,1779,1572,1606,1597,1722,1732,1703,1648,1540,1544,1661,1558,1631,1647,1647,1768,1572,1595,1508,1606,1596,1662,1559,1770,1927,1611,1810,1777,1532,1701,1784,1705,1735,1749,1508
1792,1817,1782,1661,1723,1707,1821,1816,1661,1732,1816,1842,1817,1628,1742,1878,1671,1705,1696,1776,1831,1802,1747,1639,1643,1760,1657,1730,1746,1746,1867,1670,1694,1607,1705,1695,1761,1658,1869,2014,1710,1699,1756,1631,1875,1883,1804,1834,1848,1607
1729,1754,1718,1597,1659,1643,1777,1753,1598,1669,1844,1823,1798,1565,1678,1815,1607,1641,1633,1757,1768,1739,1684,1576,1580,1697,1593,1667,1682,1682,1803,1607,1630,1543,1641,1632,1697,1594,1805,1962,1647,1728,1784,1568,1736,1819,1740,1770,1785,1543
1792,1817,1782,1661,1723,1707,1841,1816,1661,1732,1861,1886,1861,1628,1741,1878,1670,1705,1696,1820,1831,1802,1747,1639,1643,1760,1657,1730,1746,1746,1866,1670,1694,1607,1705,1695,1761,1657,1869,2026,1710,1745,1801,1631,1800,1883,1804,1834,1848,1606
1808,1833,1798,1677,1739,1723,1857,1832,1677,1748,1855,1881,1856,1644,1757,1894,1686,1721,1712,1815,1847,1818,1763,1655,1659,1776,1673,1746,1762,1762,1882,1686,1710,1623,1721,1711,1777,1673,1885,2053,1726,1739,1795,1647,1816,1899,1820,1850,1864,1622
1732,1757,1722,1601,1663,1646,1781,1756,1601,1672,1880,1826,1801,1568,1681,1818,1610,1645,1636,1760,1771,1742,1687,1579,1583,1700,1597,1670,1686,1685,1806,1610,1633,1547,1644,1635,1701,1597,1809,1966,1650,1849,1816,1571,1740,1823,1744,1774,1788,1546
