0,1,2,3,4,5,6,7,8,9,10,11,12,13,14,15,16,17,18,19,20,21,22,23,24,25,26,27,28,29,30,31,32,33,34,35,36,37,38,39,40,41,42,43,44,45,46,47,48,49
1282,1374,1325,1252,1213,1304,1215,1306,1259,1232,1262,1288,1263,1125,1301,1387,1170,1240,1294,1222,1331,1337,1333,1139,1410,1213,1157,1230,1187,1186,1357,1170,1249,1344,1243,1290,1214,1157,1369,1460,1271,1145,1202,1324,1276,1373,1304,1402,1357,1204
1443,1535,1486,1413,1373,1464,1375,1466,1419,1392,1422,1448,1423,1285,1461,1547,1331,1400,1454,1382,1491,1497,1494,1299,1570,1373,1317,1390,1347,1347,1517,1331,1446,1476,1404,1450,1374,1318,1529,1620,1431,1306,1362,1485,1436,1533,1464,1562,1517,1364
1317,1409,1360,1287,1248,1339,1250,1341,1293,1267,1296,1322,1298,1159,1335,1422,1205,1274,1328,1257,1366,1372,1368,1174,1444,1247,1191,1265,1221,1221,1391,1205,1320,1378,1278,1325,1248,1192,1403,1495,1305,1180,1236,1359,1311,1408,1338,1436,1392,1239
1318,1410,1361,1288,1248,1339,1250,1341,1294,1267,1297,1323,1298,1160,1336,1422,1206,1275,1329,1257,1366,1372,1368,1174,1445,1248,1192,1265,1222,1221,1392,1205,1320,1379,1279,1325,1249,1193,1404,1495,1306,1181,1237,1359,1311,1408,1339,1437,1392,1239
1408,1500,1451,1378,1339,1430,1341,1432,1384,1358,1387,1414,1389,1251,1426,1513,1296,1365,1419,1348,1457,1463,1459,1265,1536,1338,1283,1356,1312,1312,1482,1296,1374,1441,1369,1416,1339,1283,1494,1586,1396,1271,1327,1450,1402,1499,1430,1527,1483,1330
1305,1397,1348,1275,1235,1326,1238,1329,1281,1255,1284,1310,1285,1147,1323,1409,1193,1262,1316,1244,1354,1359,1356,1161,1432,1235,1179,1252,1209,1209,1379,1193,1271,1366,1266,1312,1236,1180,1391,1482,1293,1168,1224,1347,1299,1395,1326,1424,1379,1226
1314,1406,1357,1284,1245,1336,1247,1338,1291,1264,1294,1320,1295,1157,1332,1419,1202,1272,1326,1254,1363,1369,1365,1171,1442,1245,1189,1262,1218,1218,1389,1202,1281,1376,1275,1322,1246,1189,1401,1492,1303,1177,1234,1356,1308,1405,1336,1434,1389,1236
1230,1322,1273,1200,1160,1252,1163,1254,1206,1180,1209,1235,1210,1072,1248,1334,1118,1187,1241,1170,1279,1284,1281,1086,1357,1160,1104,1177,1134,1134,1304,1118,1196,1263,1118,1237,1161,1105,1316,1407,1218,1093,1149,1272,1224,1320,1251,1349,1305,1151
1408,1500,1451,1378,1338,1429,1340,1431,1384,1357,1387,1413,1388,1250,1426,1512,1296,1365,1419,1347,1456,1462,1459,1264,1535,1338,1282,1355,1312,1312,1482,1296,1374,1441,1369,1415,1339,1283,1494,1585,1396,1271,1327,1450,1401,1498,1429,1527,1482,1329
1219,1311,1262,1189,1150,1241,1152,1243,1195,1169,1198,1225,1200,1062,1237,1324,1107,1176,1230,1159,1268,1274,1270,1076,1347,1149,1094,1167,1123,1123,1293,1107,1222,1280,1180,1227,1150,1094,1305,1397,1207,1082,1138,1261,1213,1310,1241,1338,1294,1141
1290,1382,1333,1260,1220,1312,1223,1314,1266,1240,1269,1295,1270,1132,1308,1395,1178,1247,1301,1230,1339,1345,1341,1146,1417,1220,1164,1238,1194,1194,1364,1178,1256,1323,1251,1297,1221,1165,1376,1467,1278,1153,1209,1332,1284,1381,1311,1409,1365,1211
1310,1402,1353,1280,1241,1332,1243,1334,1287,1260,1290,1316,1291,1153,1328,1415,1198,1268,1321,1250,1359,1365,1361,1167,1438,1241,1185,1258,1214,1214,1384,1198,1276,1372,1271,1318,1242,1185,1397,1488,1299,1173,1230,1352,1304,1401,1332,1430,1385,1232
1618,1710,1661,1588,1548,1639,1550,1641,1594,1567,1597,1623,1598,1460,1636,1722,1506,1575,1629,1557,1666,1672,1668,1474,1745,1548,1492,1565,1522,1521,1692,1505,1584,1995,1578,1625,1549,1493,1704,1795,1606,1481,1537,1976,1611,1708,1639,1737,1692,1539
1288,1380,1331,1258,1218,1310,1221,1312,1264,1238,1267,1293,1268,1130,1306,1393,1176,1245,1299,1228,1337,1343,1339,1144,1415,1218,1162,1236,1192,1192,1362,1176,1254,1349,1249,1295,1219,1163,1374,1465,1276,1151,1207,1330,1282,1379,1309,1407,1363,1209
1250,1342,1293,1220,1181,1272,1183,1274,1226,1200,1229,1255,1231,1092,1268,1355,1138,1207,1261,1190,1299,1305,1301,1107,1377,1180,1124,1198,1154,1154,1324,1138,1253,1311,1211,1258,1181,1125,1336,1428,1238,1113,1169,1292,1244,1341,1271,1369,1325,1172
1316,1408,1359,1286,1246,1337,1248,1339,1292,1265,1295,1321,1296,1158,1334,1420,1204,1273,1327,1255,1364,1370,1366,1172,1443,1246,1190,1263,1220,1219,1390,1203,1318,1377,1277,1323,1247,1191,1402,1493,1304,1179,1235,1358,1309,1406,1337,1435,1390,1237
1382,1474,1425,1352,1313,1404,1315,1406,1358,1332,1361,1388,1363,1225,1400,1487,1270,1339,1393,1322,1431,1437,1433,1239,1510,1312,1257,1330,1286,1286,1456,1270,1348,1415,1343,1390,1313,1257,1468,1560,1370,1245,1301,1424,1376,1473,1404,1502,1457,1304
1253,1345,1296,1223,1183,1274,1185,1276,1229,1202,1232,1258,1233,1095,1271,1357,1141,1210,1264,1192,1301,1307,1303,1109,1380,1183,1127,1200,1157,1156,1327,1140,1255,1314,1213,1260,1184,1127,1339,1430,1241,1115,1172,1294,1246,1343,1274,1372,1327,1174
1269,1361,1312,1239,1199,1290,1202,1293,1245,1219,1248,1274,1249,1111,1287,1373,1157,1226,1280,1208,1318,1323,1320,1125,1396,1199,1143,1216,1173,1173,1343,1157,1272,1330,1230,1276,1200,1144,1355,1446,1257,1132,1188,1311,1263,1359,1290,1388,1343,1190
1272,1364,1315,1242,1203,1294,1205,1296,1249,1222,1252,1278,1253,1115,1290,1377,1160,1230,1284,1212,1321,1327,1323,1129,1400,1203,1147,1220,1176,1176,1346,1160,1275,1306,1233,1280,1204,1147,1359,1450,1261,1135,1192,1314,1266,1363,1294,1392,1347,1194
1441,1533,1484,1411,1372,1463,1374,1465,1417,1391,1420,1446,1422,1283,1459,1546,1329,1398,1452,1381,1490,1496,1492,1298,1568,1371,1315,1389,1345,1345,1515,1329,1444,1474,1402,1449,1372,1316,1527,1619,1429,1304,1360,1483,1435,1532,1462,1560,1516,1363
1281,1373,1324,1251,1211,1302,1214,1305,1257,1230,1260,1286,1261,1123,1299,1385,1169,1238,1292,1220,1330,1335,1332,1137,1408,1211,1155,1228,1185,1185,1355,1169,1284,1342,1242,1288,1212,1156,1367,1458,1269,1144,1200,1323,1275,1371,1302,1400,1355,1202
1313,1405,1356,1283,1244,1335,1246,1337,1290,1263,1293,1319,1294,1156,1331,1418,1201,1271,1324,1253,1362,1368,1364,1170,1441,1244,1188,1261,1217,1217,1387,1201,1279,1375,1274,1321,1244,1188,1400,1491,1302,1176,1232,1355,1307,1404,1335,1433,1388,1235
1265,1357,1308,1235,1196,1287,1198,1289,1241,1215,1244,1270,1246,1107,1283,1370,1153,1222,1276,1205,1314,1320,1316,1122,1392,1195,1139,1213,1169,1169,1339,1153,1231,1326,1226,1272,1196,1140,1351,1442,1253,1128,1184,1307,1259,1356,1286,1384,1340,1186
1286,1378,1329,1256,1217,1308,1219,1310,1263,1236,1266,1292,1267,1129,1304,1391,1174,1244,1297,1226,1335,1341,1337,1143,1414,1217,1161,1234,1190,1190,1360,1174,1252,1348,1247,1294,1217,1161,1373,1464,1275,1149,1206,1328,1280,1377,1308,1406,1361,1208
1379,1471,1422,1349,1309,1400,1311,1402,1355,1328,1358,1384,1359,1221,1397,1483,1267,1336,1390,1318,1427,1433,1429,1235,1506,1309,1253,1326,1283,1282,1453,1266,1381,1440,1339,1386,1310,1254,1465,1556,1367,1242,1298,1420,1372,1469,1400,1498,1453,1300
1332,1424,1375,1302,1262,1353,1264,1355,1308,1281,1311,1337,1312,1174,1350,1436,1219,1289,1343,1271,1380,1386,1382,1188,1459,1262,1206,1279,1236,1235,1406,1219,1298,1393,1292,1339,1263,1206,1418,1509,1320,1194,1251,1373,1325,1422,1353,1451,1406,1253
1263,1355,1306,1233,1194,1285,1196,1287,1239,1213,1242,1268,1244,1105,1281,1368,1151,1220,1274,1203,1312,1318,1314,1120,1390,1193,1137,1211,1167,1167,1337,1151,1266,1324,1224,1271,1194,1138,1349,1441,1251,1126,1182,1305,1257,1354,1284,1382,1338,1185
1177,1269,1220,1147,1107,1198,1109,1200,1153,1126,1156,1182,1157,1019,1195,1281,1065,1134,1188,1116,1225,1231,1227,1033,1304,1107,1051,1124,1081,1080,1251,1064,1179,1238,1138,1184,1108,1052,1263,1354,1165,1040,1096,1219,1170,1267,1198,1296,1251,1098
1408,1500,1451,1378,1339,1430,1341,1432,1384,1358,1387,1414,1389,1251,1426,1513,1296,1365,1419,1348,1457,1463,1459,1265,1536,1338,1283,1356,1312,1312,1482,1296,1374,1441,1369,1416,1339,1283,1494,1586,1396,1271,1327,1450,1402,1499,1430,1527,1483,1330
1307,1399,1350,1277,1237,1328,1239,1330,1283,1256,1286,1312,1287,1149,1325,1411,1194,1264,1318,1246,1355,1361,1357,1163,1434,1237,1181,1254,1211,1210,1381,1194,1273,1368,1267,1314,1238,1181,1393,1484,1295,1169,1226,1348,1300,1397,1328,1426,1381,1228
1303,1395,1346,1273,1234,1325,1236,1327,1279,1253,1283,1309,1284,1146,1321,1408,1191,1261,1314,1243,1352,1358,1354,1160,1431,1233,1178,1251,1207,1207,1377,1191,1306,1337,1264,1311,1234,1178,1390,1481,1291,1166,1222,1345,1297,1394,1325,1423,1378,1225
1262,1354,1305,1232,1193,1284,1195,1286,1238,1212,1242,1268,1243,1105,1280,1367,1150,1220,1273,1202,1311,1317,1313,1119,1390,1192,1137,1210,1166,1166,1336,1150,1265,1324,1150,1270,1193,1137,1349,1440,1250,1125,1181,1304,1256,1353,1284,1382,1337,1184
1295,1387,1338,1265,1226,1317,1228,1319,1271,1245,1274,1300,1276,1137,1313,1400,1183,1252,1306,1235,1344,1350,1346,1152,1422,1225,1169,1243,1199,1199,1369,1183,1261,1356,1256,1303,1226,1170,1381,1473,1283,1158,1214,1337,1289,1386,1316,1414,1370,1217
1187,1279,1230,1157,1117,1208,1119,1210,1163,1136,1166,1192,1167,1029,1205,1291,1074,1144,1198,1126,1235,1241,1237,1043,1314,1117,1061,1134,1091,1090,1261,1074,1189,1248,1147,1194,1118,1061,1273,1364,1175,1049,1106,1228,1180,1277,1208,1306,1261,1108
1320,1424,1375,1302,1263,1354,1265,1356,1308,1282,1311,1326,1313,1174,1339,1437,1220,1289,1343,1272,1381,1387,1383,1189,1459,1262,1207,1280,1236,1236,1406,1220,1298,1382,1293,1340,1263,1207,1407,1510,1320,1195,1251,1362,1326,1423,1342,1451,1407,1254
1368,1460,1411,1338,1298,1389,1300,1391,1344,1317,1347,1373,1348,1210,1386,1472,1256,1325,1379,1307,1416,1422,1418,1224,1495,1298,1242,1315,1272,1271,1442,1255,1370,1429,1328,1375,1299,1242,1454,1545,1356,1230,1287,1409,1361,1458,1389,1487,1442,1289
1441,1533,1484,1411,1372,1463,1374,1465,1417,1391,1420,1446,1422,1283,1459,1546,1329,1398,1452,1381,1490,1496,1492,1298,1568,1371,1315,1389,1345,1345,1515,1329,1444,1474,1402,1449,1372,1316,1527,1619,1429,1304,1360,1483,1435,1532,1462,1560,1516,1363
1332,1424,1375,1302,1262,1353,1264,1355,1308,1281,1311,1337,1312,1174,1350,1436,1219,1289,1343,1271,1380,1386,1382,1188,1459,1262,1206,1279,1236,1235,1406,1219,1298,1393,1292,1339,1263,1206,1418,1509,1320,1194,1251,1373,1325,1422,1353,1451,1406,1253
1254,1345,1297,1224,1184,1275,1186,1277,1230,1203,1233,1259,1234,1096,1272,1358,1141,1211,1265,1193,1302,1308,1304,1110,1381,1184,1128,1201,1158,1157,1328,1141,1220,1315,1214,1261,1185,1128,1340,1431,1242,1116,1173,1295,1247,1344,1275,1373,1328,1175
1263,1355,1306,1233,1194,1285,1196,1287,1240,1213,1243,1269,1244,1106,1281,1368,1151,1221,1274,1203,1312,1318,1314,1120,1391,1194,1138,1211,1167,1167,1337,1151,1266,1297,1151,1271,1194,1138,1350,1441,1252,1126,1183,1305,1257,1354,1285,1383,1338,1185
1258,1350,1301,1228,1189,1280,1191,1282,1234,1208,1237,1264,1239,1101,1276,1363,1146,1215,1269,1198,1307,1313,1309,1115,1386,1188,1133,1206,1162,1162,1332,1146,1261,1319,1219,1266,1189,1133,1344,1436,1246,1121,1177,1300,1252,1349,1280,1377,1333,1180
1249,1341,1292,1219,1180,1271,1182,1273,1225,1199,1228,1254,1230,1091,1267,1354,1137,1206,1260,1189,1298,1304,1300,1106,1376,1179,1123,1197,1153,1153,1323,1137,1252,1310,1210,1257,1180,1124,1335,1427,1237,1112,1168,1291,1243,1340,1270,1368,1324,1171
1285,1377,1328,1255,1216,1307,1218,1309,1261,1235,1264,1290,1266,1127,1303,1390,1173,1242,1296,1225,1334,1340,1336,1142,1412,1215,1159,1233,1189,1189,1359,1173,1251,1346,1246,1293,1216,1160,1371,1463,1273,1148,1204,1327,1279,1376,1306,1404,1360,1207
1265,1357,1308,1235,1195,1286,1197,1288,1241,1214,1244,1270,1245,1107,1283,1369,1153,1222,1276,1204,1313,1319,1315,1121,1392,1195,1139,1212,1169,1168,1339,1152,1231,1326,1225,1272,1196,1139,1351,1442,1253,1127,1184,1306,1258,1355,1286,1384,1339,1186
1402,1494,1445,1372,1333,1424,1335,1426,1379,1352,1382,1408,1383,1245,1420,1507,1290,1360,1413,1342,1451,1457,1453,1259,1530,1333,1277,1350,1306,1306,1476,1290,1368,1436,1363,1410,1333,1277,1489,1580,1391,1265,1322,1444,1396,1493,1424,1522,1477,1324
1359,1451,1402,1329,1289,1380,1291,1382,1335,1308,1338,1364,1339,1201,1377,1463,1247,1316,1370,1298,1408,1413,1410,1215,1486,1289,1233,1306,1263,1263,1433,1247,1325,1420,1320,1366,1290,1234,1445,1536,1347,1222,1278,1401,1352,1449,1380,1478,1433,1280
1304,1396,1347,1274,1235,1326,1237,1328,1280,1254,1283,1309,1285,1146,1322,1409,1192,1261,1315,1244,1353,1359,1355,1161,1431,1234,1178,1252,1208,1208,1378,1192,1270,1365,1265,1312,1235,1179,1390,1482,1292,1167,1223,1346,1298,1395,1325,1423,1379,1226
1310,1402,1353,1280,1240,1331,1242,1333,1286,1259,1289,1315,1290,1152,1328,1414,1198,1267,1321,1249,1358,1364,1360,1166,1437,1240,1184,1257,1214,1213,1384,1197,1276,1371,1270,1317,1241,1185,1396,1487,1298,1173,1229,1351,1303,1400,1331,1429,1384,1231
1256,1348,1299,1226,1187,1278,1189,1280,1233,1206,1236,1262,1237,1099,1274,1361,1144,1214,1267,1196,1305,1311,1307,1113,1384,1187,1131,1204,1160,1160,1330,1144,1259,1318,1217,1264,1188,1131,1343,1434,1245,1119,1176,1298,1250,1347,1278,1376,1331,1178
